00-00-00
01-00-00
01-00-01
02-00-00
02-00-01
02-01-00
02-01-01
03-00-00
03-00-01
04-00-00
04-00-01
04-01-00
04-01-01
05-00-00
05-01-00
05-01-01
06-00-00
06-00-01
06-00-02
06-01-00
07-00-00
07-00-01
07-01-00
08-00-00
08-01-00
09-00-00
09-00-01
10-00-00
11-00-00
12-00-00
12-00-01
12-00-02
13-00-00
13-01-00
13-01-01
13-01-02
14-00-00
14-01-00
14-01-01
15-00-00
15-00-01
15-01-00
16-00-00
17-00-00
17-00-01
17-01-00
17-01-01
18-00-00
18-01-00